Layer name,version,num of weights,num of zero weights,num of unique weights,num of abs weights,num of delta weights,abs unique weights storage(bits) ,delta uniqie weights storage(bits),total unique weights storage(bits),num of weight repetition elements,unique weight repetition storage(bits),total weight storage(bits),total cycle without bubbles,total cycle with bubbles,total cycle overhead,min total idx memory storage,total number of bubbles
conv1/7x7_s2,V1,9408,740,2391,335,2056,3015,4112,7127,2895,8685,15812,2938,4130,40.57181756296801,75714.0,3665
conv1/7x7_s2,V2,9408,740,2436,225,2211,2025,4422,6447,2940,8820,15267,2938,4130,40.57181756296801,75714.0,3665
conv2/3x3_reduce,V1,4096,188,3762,601,3161,5409,15805,21214,3767,7534,28748,1024,1542,50.5859375,15328.0,1417
conv2/3x3_reduce,V2,4096,188,3769,0,3769,0,18845,18845,3777,7554,26399,1024,1542,50.5859375,15328.0,1417
conv2/3x3,V1,110592,15657,35766,3459,32307,31131,64614,95745,37516,112548,208293,25540,37629,47.33359436178544,672739.0,51652
conv2/3x3,V2,110592,15657,36080,2154,33926,19386,67852,87238,37830,113490,200728,25540,37629,47.33359436178544,672739.0,51652
inception_3a/1x1,V1,12288,1187,10185,1511,8674,13599,34696,48295,10227,20454,68749,3063,4434,44.76003917727718,43170.0,3989
inception_3a/1x1,V2,12288,1187,10365,0,10365,0,41460,41460,10402,20804,62264,3063,4434,44.76003917727718,43170.0,3989
inception_3a/3x3_reduce,V1,18432,1895,15118,1823,13295,16407,53180,69587,15187,30374,99961,4593,6604,43.784019159590684,64466.0,5951
inception_3a/3x3_reduce,V2,18432,1895,15426,0,15426,0,61704,61704,15486,30972,92676,4593,6604,43.784019159590684,64466.0,5951
inception_3a/3x3,V1,110592,19265,29547,2253,27294,20277,54588,74865,32336,97008,171873,24832,35967,44.8413337628866,629606.0,48777
inception_3a/3x3,V2,110592,19265,29787,1308,28479,11772,56958,68730,32576,97728,166458,24832,35967,44.8413337628866,629606.0,48777
inception_3a/5x5_reduce,V1,3072,309,2462,274,2188,2466,8752,11218,2476,4952,16170,767,1093,42.503259452411996,10764.0,962
inception_3a/5x5_reduce,V2,3072,309,2515,0,2515,0,10060,10060,2530,5060,15120,767,1093,42.503259452411996,10764.0,962
inception_3a/5x5,V1,12800,2452,1965,213,1752,1917,3504,5421,2848,8544,13965,2777,4105,47.82138998919697,82375.0,5760
inception_3a/5x5,V2,12800,2452,1980,141,1839,1269,3678,4947,2863,8589,13536,2777,4105,47.82138998919697,82375.0,5760
inception_3a/pool_proj,V1,6144,484,5208,886,4322,7974,17288,25262,5232,10464,35726,1531,2235,45.983017635532335,21974.0,1997
inception_3a/pool_proj,V2,6144,484,5311,0,5311,0,21244,21244,5338,10676,31920,1531,2235,45.983017635532335,21974.0,1997
inception_3b/1x1,V1,32768,4288,25223,5354,19869,48186,59607,107793,25440,50880,158673,8114,11421,40.75671678580232,110500.0,10373
inception_3b/1x1,V2,32768,4288,25908,458,25450,4122,76350,80472,26077,52154,132626,8114,11421,40.75671678580232,110500.0,10373
inception_3b/3x3_reduce,V1,32768,3443,26389,2162,24227,19458,96908,116366,26569,53138,169504,8168,11720,43.48677766895201,114094.0,10566
inception_3b/3x3_reduce,V2,32768,3443,27140,0,27140,0,108560,108560,27287,54574,163134,8168,11720,43.48677766895201,114094.0,10566
inception_3b/3x3,V1,221184,43937,49323,2705,46618,24345,93236,117581,56722,170166,287747,48450,68928,42.26625386996904,1218693.0,91481
inception_3b/3x3,V2,221184,43937,49523,1525,47998,13725,95996,109721,56922,170766,280487,48450,68928,42.26625386996904,1218693.0,91481
inception_3b/5x5_reduce,V1,8192,1046,6385,601,5784,5409,23136,28545,6447,12894,41439,2028,2864,41.222879684418146,27833.0,2587
inception_3b/5x5_reduce,V2,8192,1046,6567,0,6567,0,26268,26268,6619,13238,39506,2028,2864,41.222879684418146,27833.0,2587
inception_3b/5x5,V1,76800,15636,8348,453,7895,4077,15790,19867,9813,39252,59119,16321,23890,46.37583481404326,461498.0,33293
inception_3b/5x5,V2,76800,15636,8385,272,8113,2448,16226,18674,9850,39400,58074,16321,23890,46.37583481404326,461498.0,33293
inception_3b/pool_proj,V1,16384,1869,12966,986,11980,8874,47920,56794,13065,26130,82924,4071,5826,43.109801031687546,56435.0,5321
inception_3b/pool_proj,V2,16384,1869,13320,0,13320,0,53280,53280,13390,26780,80060,4071,5826,43.109801031687546,56435.0,5321
inception_4a/1x1,V1,92160,13429,68798,11814,56984,106326,170952,277278,69535,139070,416348,22780,31589,38.66988586479368,305145.0,28085
inception_4a/1x1,V2,92160,13429,70811,687,70124,6183,210372,216555,71425,142850,359405,22780,31589,38.66988586479368,305145.0,28085
inception_4a/3x3_reduce,V1,46080,6106,35305,7192,28113,64728,84339,149067,35621,71242,220309,11403,15988,40.208717004297114,155193.0,14372
inception_4a/3x3_reduce,V2,46080,6106,36338,561,35777,5049,107331,112380,36591,73182,185562,11403,15988,40.208717004297114,155193.0,14372
inception_4a/3x3,V1,179712,33581,43064,2662,40402,23958,80804,104762,48443,145329,250091,39904,57318,43.639735364875705,991648.0,77135
inception_4a/3x3,V2,179712,33581,43304,1550,41754,13950,83508,97458,48683,146049,243507,39904,57318,43.639735364875705,991648.0,77135
inception_4a/5x5_reduce,V1,7680,1255,5576,828,4748,7452,14244,21696,5645,11290,32986,1880,2594,37.97872340425532,24889.0,2308
inception_4a/5x5_reduce,V2,7680,1255,5710,53,5657,477,16971,17448,5772,11544,28992,1880,2594,37.97872340425532,24889.0,2308
inception_4a/5x5,V1,19200,3497,2454,149,2305,1341,4610,5951,2738,10952,16903,4163,6057,45.49603651213067,122353.0,8238
inception_4a/5x5,V2,19200,3497,2467,98,2369,882,4738,5620,2751,11004,16624,4163,6057,45.49603651213067,122353.0,8238
inception_4a/pool_proj,V1,30720,4189,23354,4379,18975,39411,56925,96336,23602,47204,143540,7584,10587,39.596518987341774,103073.0,9466
inception_4a/pool_proj,V2,30720,4189,24048,134,23914,1206,71742,72948,24243,48486,121434,7584,10587,39.596518987341774,103073.0,9466
inception_4b/1x1,V1,81920,14946,56729,7206,49523,64854,148569,213423,56729,170187,383610,19941,26905,34.92302291760694,257795.0,23187
inception_4b/1x1,V2,81920,14946,58220,474,57746,4266,173238,177504,58220,174660,352164,19941,26905,34.92302291760694,257795.0,23187
inception_4b/3x3_reduce,V1,57344,10297,39929,4881,35048,43929,105144,149073,40562,81124,230197,14004,19044,35.98971722365039,181872.0,16792
inception_4b/3x3_reduce,V2,57344,10297,41036,401,40635,3609,121905,125514,41579,83158,208672,14004,19044,35.98971722365039,181872.0,16792
inception_4b/3x3,V1,225792,59861,38755,1621,37134,14589,74268,88857,48755,146265,235122,46780,65400,39.80333475844378,1086607.0,87671
inception_4b/3x3,V2,225792,59861,38905,835,38070,7515,76140,83655,48905,146715,230370,46780,65400,39.80333475844378,1086607.0,87671
inception_4b/5x5_reduce,V1,12288,2053,8876,1531,7345,13779,22035,35814,8991,17982,53796,3014,4148,37.62441937624419,39620.0,3650
inception_4b/5x5_reduce,V2,12288,2053,9131,127,9004,1143,27012,28155,9232,18464,46619,3014,4148,37.62441937624419,39620.0,3650
inception_4b/5x5,V1,38400,7556,4186,205,3981,1845,7962,9807,4914,19656,29463,8268,11963,44.6903725205612,232565.0,16490
inception_4b/5x5,V2,38400,7556,4204,121,4083,1089,8166,9255,4932,19728,28983,8268,11963,44.6903725205612,232565.0,16490
inception_4b/pool_proj,V1,32768,5018,23948,3491,20457,31419,61371,92790,24260,48520,141310,8078,11050,36.7912849715276,107226.0,9783
inception_4b/pool_proj,V2,32768,5018,24678,172,24506,1548,73518,75066,24941,49882,124948,8078,11050,36.7912849715276,107226.0,9783
inception_4c/1x1,V1,65536,9909,47936,7376,40560,66384,121680,188064,48583,97166,285230,16142,22262,37.91351753190435,214971.0,19702
inception_4c/1x1,V2,65536,9909,49303,396,48907,3564,146721,150285,49855,99710,249995,16142,22262,37.91351753190435,214971.0,19702
inception_4c/3x3_reduce,V1,65536,10056,48031,6963,41068,62667,123204,185871,48602,97204,283075,16144,22241,37.76635282457879,214480.0,19686
inception_4c/3x3_reduce,V2,65536,10056,49383,398,48985,3582,146955,150537,49861,99722,250259,16144,22241,37.76635282457879,214480.0,19686
inception_4c/3x3,V1,294912,78570,49704,2106,47598,18954,95196,114150,122729,245458,359608,61617,85826,39.28948179885421,1410044.0,116040
inception_4c/3x3,V2,294912,78570,49852,1102,48750,9918,97500,107418,122853,245706,353124,61617,85826,39.28948179885421,1410044.0,116040
inception_4c/5x5_reduce,V1,12288,1798,9225,1685,7540,15165,22620,37785,9320,18640,56425,3018,4218,39.761431411530815,40735.0,3768
inception_4c/5x5_reduce,V2,12288,1798,9487,130,9357,1170,28071,29241,9572,19144,48385,3018,4218,39.761431411530815,40735.0,3768
inception_4c/5x5,V1,38400,8113,4036,223,3813,2007,7626,9633,4748,18992,28625,8218,11927,45.132635677780485,225422.0,16697
inception_4c/5x5,V2,38400,8113,4060,132,3928,1188,7856,9044,4772,19088,28132,8218,11927,45.132635677780485,225422.0,16697
inception_4c/pool_proj,V1,32768,5584,23276,2949,20327,26541,60981,87522,23583,47166,134688,8029,10919,35.99451986548761,105149.0,9731
inception_4c/pool_proj,V2,32768,5584,23949,76,23873,684,71619,72303,24211,48422,120725,8029,10919,35.99451986548761,105149.0,9731
inception_4d/1x1,V1,57344,9199,41227,5852,35375,52668,106125,158793,41810,83620,242413,14100,19365,37.340425531914896,186295.0,17125
inception_4d/1x1,V2,57344,9199,42465,267,42198,2403,126594,128997,42946,85892,214889,14100,19365,37.340425531914896,186295.0,17125
inception_4d/3x3_reduce,V1,73728,9751,56359,10225,46134,92025,138402,230427,56885,113770,344197,18250,25541,39.95068493150685,248087.0,22741
inception_4d/3x3_reduce,V2,73728,9751,58045,491,57554,4419,172662,177081,58474,116948,294029,18250,25541,39.95068493150685,248087.0,22741
inception_4d/3x3,V1,373248,96752,61364,1909,59455,17181,118910,136091,78930,236790,372881,79607,111264,39.766603439396036,1780516.0,152848
inception_4d/3x3,V2,373248,96752,61584,919,60665,8271,121330,129601,79149,237447,367048,79607,111264,39.766603439396036,1780516.0,152848
inception_4d/5x5_reduce,V1,16384,2562,11996,1804,10192,16236,30576,46812,12132,24264,71076,4022,5571,38.51317752362009,53406.0,4902
inception_4d/5x5_reduce,V2,16384,2562,12311,99,12212,891,36636,37527,12433,24866,62393,4022,5571,38.51317752362009,53406.0,4902
inception_4d/5x5,V1,51200,11832,4650,160,4490,1440,8980,10420,5770,23080,33500,10792,15618,44.71830985915493,286725.0,22215
inception_4d/5x5,V2,51200,11832,4670,86,4584,774,9168,9942,5790,23160,33102,10792,15618,44.71830985915493,286725.0,22215
inception_4d/pool_proj,V1,32768,5247,23664,3277,20387,29493,61161,90654,23991,47982,138636,8063,11053,37.08297159866055,106555.0,9769
inception_4d/pool_proj,V2,32768,5247,24369,141,24228,1269,72684,73953,24649,49298,123251,8063,11053,37.08297159866055,106555.0,9769
inception_4e/1x1,V1,135168,32264,82912,5392,77520,48528,232560,281088,85269,170538,451626,32130,42121,31.095549330843447,395009.0,36084
inception_4e/1x1,V2,135168,32264,84624,468,84156,4212,252468,256680,86797,173594,430274,32130,42121,31.095549330843447,395009.0,36084
inception_4e/3x3_reduce,V1,84480,17605,55005,4401,50604,39609,151812,191421,56221,112442,303863,20395,27106,32.90512380485413,257369.0,23427
inception_4e/3x3_reduce,V2,84480,17605,56341,159,56182,1431,168546,169977,57418,114836,284813,20395,27106,32.90512380485413,257369.0,23427
inception_4e/3x3,V1,460800,215506,44407,774,43633,6966,87266,94232,46616,186464,280696,79417,103393,30.1900096956571,1454451.0,142879
inception_4e/3x3,V2,460800,215506,44564,329,44235,2961,88470,91431,46773,187092,278523,79417,103393,30.1900096956571,1454451.0,142879
inception_4e/5x5_reduce,V1,16896,2835,11993,1507,10486,13563,31458,45021,12187,24374,69395,4156,5627,35.39461020211742,54236.0,4929
inception_4e/5x5_reduce,V2,16896,2835,12345,93,12252,837,36756,37593,12505,25010,62603,4156,5627,35.39461020211742,54236.0,4929
inception_4e/5x5,V1,102400,31452,6631,171,6460,1539,12920,14459,6937,34685,49144,20004,28201,40.976804639072185,482588.0,40068
inception_4e/5x5,V2,102400,31452,6655,76,6579,684,13158,13842,6961,34805,48647,20004,28201,40.976804639072185,482588.0,40068
inception_4e/pool_proj,V1,67584,12743,46037,4608,41429,41472,124287,165759,46859,93718,259477,16463,22137,34.465164307841825,211557.0,19276
inception_4e/pool_proj,V2,67584,12743,47278,208,47070,1872,141210,143082,47974,95948,239030,16463,22137,34.465164307841825,211557.0,19276
inception_5a/1x1,V1,212992,52982,129532,8284,121248,74556,363744,438300,133030,266060,704360,50464,65607,30.007530120481928,613617.0,55208
inception_5a/1x1,V2,212992,52982,132371,298,132073,2682,396219,398901,135597,271194,670095,50464,65607,30.007530120481928,613617.0,55208
inception_5a/3x3_reduce,V1,133120,30515,84115,6070,78045,54630,234135,288765,86106,172212,460977,31837,41849,31.447686653893268,394264.0,35733
inception_5a/3x3_reduce,V2,133120,30515,86078,130,85948,1170,257844,259014,87848,175696,434710,31837,41849,31.447686653893268,394264.0,35733
inception_5a/3x3,V1,460800,161924,51419,536,50883,4824,101766,106590,53606,214424,321014,91759,122584,33.59343497640558,1757001.0,168213
inception_5a/3x3,V2,460800,161924,51641,183,51458,1647,102916,104563,53828,215312,319875,91759,122584,33.59343497640558,1757001.0,168213
inception_5a/5x5_reduce,V1,26624,5390,17848,1811,16037,16299,48111,64410,18187,36374,100784,6422,8605,33.99252569293055,81526.0,7375
inception_5a/5x5_reduce,V2,26624,5390,18319,61,18258,549,54774,55323,18616,37232,92555,6422,8605,33.99252569293055,81526.0,7375
inception_5a/5x5,V1,102400,27833,7554,179,7375,1611,14750,16361,7745,38725,55086,20879,29960,43.49346233057139,520308.0,43388
inception_5a/5x5,V2,102400,27833,7577,94,7483,846,14966,15812,7768,38840,54652,20879,29960,43.49346233057139,520308.0,43388
inception_5a/pool_proj,V1,106496,19932,72912,7660,65252,68940,195756,264696,74206,148412,413108,25932,34971,34.85654789449329,333560.0,30324
inception_5a/pool_proj,V2,106496,19932,74967,138,74829,1242,224487,225729,76101,152202,377931,25932,34971,34.85654789449329,333560.0,30324
inception_5b/1x1,V1,319488,79911,189982,7570,182412,68130,547236,615366,196026,392052,1007418,75342,98124,30.238114199251413,917781.0,83421
inception_5b/1x1,V2,319488,79911,194040,103,193937,927,581811,582738,199645,399290,982028,75342,98124,30.238114199251413,917781.0,83421
inception_5b/3x3_reduce,V1,159744,28311,110776,10446,100330,94014,300990,395004,112638,225276,620280,39079,52701,34.85759615138566,507091.0,46167
inception_5b/3x3_reduce,V2,159744,28311,114032,169,113863,1521,341589,343110,115579,231158,574268,39079,52701,34.85759615138566,507091.0,46167
inception_5b/3x3,V1,663552,245388,61202,302,60900,2718,121800,124518,66131,264524,389042,134226,174402,29.93160788520853,2321639.0,234091
inception_5b/3x3,V2,663552,245388,61387,69,61318,621,122636,123257,66316,265264,388521,134226,174402,29.93160788520853,2321639.0,234091
inception_5b/5x5_reduce,V1,39936,6869,27929,2752,25177,24768,75531,100299,28405,56810,157109,9798,13300,35.741988160849154,127667.0,11728
inception_5b/5x5_reduce,V2,39936,6869,28792,31,28761,279,86283,86562,29190,58380,144942,9798,13300,35.741988160849154,127667.0,11728
inception_5b/5x5,V1,153600,64085,6500,11,6489,99,12978,13077,7303,36515,49592,27815,37169,33.62933668883696,545459.0,54379
inception_5b/5x5,V2,153600,64085,6509,1,6508,9,13016,13025,7312,36560,49585,27815,37169,33.62933668883696,545459.0,54379
inception_5b/pool_proj,V1,106496,24598,66063,3284,62779,29556,188337,217893,67817,135634,353527,25393,33416,31.595321545307762,314493.0,28680
inception_5b/pool_proj,V2,106496,24598,67653,26,67627,234,202881,203115,69228,138456,341571,25393,33416,31.595321545307762,314493.0,28680
